NO ./texture_pack/ghast.xpm
SO ./texture_pack/ghast.xpm
WE ./texture_pack/ghast.xpm
EA ./texture_pack/ghast.xpm

F 220,100,0
C 225,30,0

    1111
1111111111111111111111111
1111000000001000000000001111
   10000000001000000000000001
1111000000000000000000001111
100000010000W000000010001
1000000011000000000100001
1000000000100100000000001
1111111111111111111111111
