NO ./path_to_the_north_texture
SO ./path_to_the_south_texture
WE ./path_to_the_west_texture
EA ./path_to_the_east_texture

F 220,100,0
C 225,30,0

1111111111111111111111111   
1000000000000000000000001   1
101111111111111111111110111111111111111111111111111111
1010000000000000000000101    1000000000000000000000001
1010111111111111111110101  111011111111111111111111011
10101011111   11111110101    1011                 1011
10101011111 1 11111110101    100011111            101
1010121111111111111110101    101000001            12111111
101010000000000000000010111   111111001           10000001
101011111111111111111110001111100000001     1111  11111101
101000000000000000000000100000001111111111110N001111111101  
11111111111111111111111111111111    101     1111      1101
       1111111111111111        1111111                 101
    1111000000000000001                                101
1111111101111111111111211111111111111111111111111111111101
1000020000000000000000000000000000000000000000000000002001
1111111111111111111111111111111111111111111111111111111111