NO ./texture_pack/ghast.xpm
SO ./texture_pack/red.xpm
F 100,0,0
WE ./texture_pack/green.xpm
EA ./texture_pack/blue.xpm

C 30,0,0

1111111111111111111111111
1000000000000000000000001
1000000000000000000000001
1000000000000000000000001
1000000W00001000000000001
1000000000000000000000001
1000000000000000000000001 1111
1000000000000000000000001 1001
1111111111111111111111111 1111
